R 1080 720
F 97,63,16
C 0,191,255
NO textures/w1.xpm
SO textures/w4.xpm
WE textures/w3.xpm
EA textures/w2.xpm
S textures/coin.xpm

 111111111111111111111111111111 1111111111111     111111111111111111111111 
1000000000000000000000000000001110000000000011111110000000000000000000001
1000000000000000000000000000000000000000000001001100000000000000000000001
 100000000000000000000000000000000100000001000001100000000000000002000001
 110000000000000000000000000000011111100010000010000000000000000000000011
   100000000000000000000000000001    10000000001000000000000000000000001
   100000000000000000000000000001    11000000000000000000000000000000201
   100001000000000000000000000011111111000000000000000000000000000000011
  1100100000000000001110000000000100000000000001000000000000000000000011
 11000000100000001001111000000000000000000100000000000000000000000000001
100000001100000000000011000000000000000000000000000000000000000100000001
100W001000000000010000010000000000N0000000000000000000000000000000000001
 10000000000010000000220000000010000000000000000100000000000000000000001
 10001000000000100010000000000000000000000100000000000000000000000000021
 10000000000000100000000000000000011000000111000000000000000100000000001
  1111000000000111000000000000000100000001111100001000000000100000000001
     10000000111 1100000000001110000001111 10000011100000000000000000001
    10000000001   10000101111000000101     10001000010000110000000000001
     1110000011  11111110000101011001      1111 111000010000000000000001
    1000011111   100000001000001             1001110000000000000001
     110101     1100100000110001             11101100000000000000001
      1000111 11100000000001111                101110000000000000001
     11011011 10000000000111                   111100000000000001111
     100000011000000000011                       10000000000000011
      1000001110000000101                          100100000000001
      1000001000000001111                          100000000000001
      1010000000000001                             1000100000000011
      1111100020000000001                          11100100000010011
      1001110000001000001                            1111000200001011 
      10000000000000000001                              1101111000101 
      1000000000000000011001                             111  1001101 
      10020010000000001 101                                   11011001
      10001100020000011 111                                    1011001
      1011 10000000011                                         1001101
      111  1100000011                                          1101001
            10001011                                            1100001
            1111001                                              10001
               1111                                              10001
                                                                 11001 
                                                                  1111  