R 1080 720
F 97,63,16
C 0,191,255
NO textures/w1.xpm
SO textures/w4.xpm
WE textures/w3.xpm
EA textures/w2.xpm
S textures/coin.xpm

111111111111111111111111
100000000000000000000011
1000000200000N0000000011
100000000000000000000011
100000000200000000000011
111111111111111111111111